I started my schooling as the majority did in my area, at the local primarry school. I then
went to the local secondarry school and recieved grades in English, Maths, Phisics,
Biology, Geography, Art, Graphical Comunication and Philosophy of Religeon. I'll not
bore you with the 'A' levels and above.
Notice the ambigous English qualification above. It was, in truth, a cource dedicated to
reading "Lord of the flies" and other gems, and a weak atempt at getting us to
commprehend them. Luckilly my middle-class upbringing gave me a head start as I was
already aquainted with that sort of langauge these books used (and not just the Peter and
Jane books) and had read simillar books before. I will never be able to put that paticular
course down as much as I desire to because, for all its faults, it introduced me to
,  and the wonders of Lenny, mice and pockets.
My education never included one iota of grammar. Lynn Truss points out in "Eats,
shoots and leaves" that many people were excused from the rigours of learning English
grammar during their schooling over the last 30 or so years because the majority or
decision-makers decided one day that it might hinder imagination and expresion (so
what, I ask, happened to all those expresive and imaginative people before the ruling?).

abandonned->abandoned
absorbsion->absorption
absorbtion->absorption
abudance->abundance
abundacies->abundances
abundancies->abundances
abundunt->abundant
abutts->abuts
acadamy->academy
acadmic->academic
accademic->academic
accademy->academy
acccused->accused
accelleration->acceleration
accension->accession, ascension
accordian->accordion
accoring->according
accoustic->acoustic
accquainted->acquainted
accrediation->accreditation
accredidation->accreditation
achievment->achievement
achievments->achievements
achive->achieve, archive
achived->achieved, archived
achivement->achievement
achivements->achievements
acknowldeged->acknowledged
acknowledgeing->acknowledging
ackward->awkward, backward
acommodate->accommodate
acomplish->accomplish
acomplished->accomplished
acomplishment->accomplishment
acomplishments->accomplishments
acording->according
acordingly->accordingly
acquaintence->acquaintance
acquaintences->acquaintances
acquiantence->acquaintance
addopted->adopted
addoptive->adoptive
addres->address, adders
addresable->addressable
adherance->adherence
admendment->amendment
admininistrative->administrative
adminstered->administered
adminstrate->administrate
adminstration->administration
adminstrative->administrative
adminstrator->administrator
admissability->admissibility
admissable->admissible
admited->admitted
admitedly->admittedly
adolecent->adolescent
adquire->acquire
adquired->acquired
adquires->acquires
adquiring->acquiring
adres->address
adresable->addressable
adresing->addressing
adress->address
adressable->addressable
adressed->addressed
agian->again
agianst->against
agin->again
agina->again, angina
ammendment->amendment
ammendments->amendments
ammount->amount
ammused->amused
ancilliary->ancillaryanthropomorphization
anthropolgist->anthropologist
anthropolgy->anthropology
anual->annual
anulled->annulled
anwsered->answered
anyhwere->anywhere
archetectural->architectural
archetecturally->architecturally
archetecture->architecture
archiac->archaic
archictect->architect
archimedian->archimedean
architecht->architect
architechturally->architecturally
arogent->arrogant
aroud->around
arrangment->arrangement
arrangments->arrangements
arrengement->arrangement
availiable->available
availible->available
avalable->available
avalance->avalanche
basicaly->basically
basicly->basically
bcak->back
begginer->beginner
begginers->beginners
calander->calendar, calender, colander
calculater->calculator
calculs->calculus
calenders->calendars
caligraphy->calligraphy
caluclate->calculate
caluclated->calculated
caluculate->calculate
caluculated->calculated
calulate->calculate
calulated->calculated
calulater->calculator
Cambrige->Cambridge
camoflage->camouflage
campagin->campaign
campain->campaign
campains->campaigns
candadate->candidate
candiate->candidate
candidiate->candidate
cannister->canister
carcas->carcass, Caracas
carefull->careful
careing->caring
carismatic->charismatic
Carmalite->Carmelite
Carnagie->Carnegie
Carnagie-Mellon->Carnegie-Mellon
carnege->carnage, Carnegie
carnige->carnage, Carnegie
Carnigie->Carnegie
Carnigie-Mellon->Carnegie-Mellon
carreer->career
carrers->careers
Carribbean->Caribbean
Carribean->Caribbean
carryng->carrying
cartdridge->cartridge
Carthagian->Carthaginian
carthographer->cartographer
catagory->category
Cataline->Catiline, Catalina
catapillar->caterpillar
catapillars->caterpillars
catapiller->caterpillar
catapillers->caterpillars
catepillar->caterpillar
comissioner->commissioner
comissioning->commissioning
comissions->commissions
comited->committed
comiting->committing
comitted->committed
comittee->committee
comitting->committing
commandoes->commandos
commited->committed
commitee->committee
commiting->committing
committe->committee
committment->commitment
committments->commitments
commmemorated->commemorated
commongly->commonly
commonweath->commonwealth
commuications->communications
commuinications->communications
communciation->communication
communiation->communication
communites->communities
compability->compatibility
comparision->comparison
comparisions->comparisons
comparitive->comparative
comparitively->comparatively
compatabilities->compatibilities
compatability->compatibility
compatable->compatible
compatablities->compatibilities
compatablity->compatibility
compatiable->compatible
compatiblities->compatibilities
comprimise->compromise
compulsary->compulsory
compulsery->compulsory
computarized->computerized
concensus->consensus
concider->consider
concidered->considered
concidering->considering
conciders->considers
concieted->conceited
concieved->conceived
concious->conscious
conciously->consciously
conciousness->consciousness
condamned->condemned
condemmed->condemned
condidtion->condition
condidtions->conditions
conditionsof->conditions of
conected->connected
conquerers->conquerors
conqured->conquered
conscent->consent
consciouness->consciousness
consdider->consider
consdidered->considered
consdiered->considered
consectutive->consecutive
consenquently->consequently
consentrate->concentrate
consentrated->concentrated
consentrates->concentrates
consept->concept
consequentually->consequently
consequeseces->consequences
consern->concern
conserned->concerned
conserning->concerning
conservitive->conservative
consiciousness->consciousness
consicousness->consciousness
considerd->considered
consorcium->consortium
conspiracys->conspiracies
conspiriator->conspirator
constaints->constraints
constanly->constantly
constarnation->consternation
constatn->constant
controled->controlled
controling->controlling
controll->control
controlls->controls
controvercial->controversial
controvercy->controversy
controveries->controversies
controversal->controversial
controversey->controversy
copmetitors->competitors
coputer->computer
copywrite->copyright
coridal->cordial
cornmitted->committed
corosion->corrosion
corparate->corporate
corperations->corporations
correcters->correctors
correponding->corresponding
correposding->corresponding
correspondant->correspondent
correspondants->correspondents
corridoors->corridors
corrispond->correspond
corrispondant->correspondent
corrispondants->correspondents
corrisponded->corresponded
corrisponding->corresponding
corrisponds->corresponds
costitution->constitution
creche->crÃ¨che
creedence->credence
critereon->criterion
criterias->criteria
criticists->critics
critising->criticising, criticizing
critisising->criticising
critisism->criticism
critisisms->criticisms
critisize->criticise, criticize
critisized->criticised, criticized
critisizes->criticises, criticizes
critisizing->criticising, criticizing
critized->criticized
critizing->criticizing
crockodiles->crocodiles
crowm->crown
crtical->critical
crticised->criticised
crucifiction->crucifixion
crusies->cruises
crutial->crucial
crystalisation->crystallisation
culiminating->culminating
cumulatative->cumulative
curch->church
curcuit->circuit
currenly->currently
decendants->descendants
decendent->descendant
defendent->defendant
defendents->defendants
deffensively->defensively
deffine->define
deffined->defined
definance->defiance
delapidated->dilapidated
delerious->delirious
delevopment->development
deliberatly->deliberately
delusionally->delusively
demenor->demeanor
demographical->demographic
demolision->demolition
demorcracy->democracy
demostration->demonstration
denegrating->denigrating
densly->densely
deparment->department
deparmental->departmental
deparments->departments
dependance->dependence
dependancy->dependency
deram->dram, dream
deriviated->derived
derivitive->derivative
derogitory->derogatory
descendands->descendants
descibed->described
descision->decision
descisions->decisions
descriibes->describes
descripters->descriptors
desitned->destined
desktiop->desktop
desorder->disorder
desoriented->disoriented
desparate->desperate, disparate
despict->depict
despiration->desperation
determinining->determining
detremental->detrimental
devasted->devastated
develope->develop
developement->development
developped->developed
develpment->development
devels->delves
dimention->dimension
dimentional->dimensional
dimentions->dimensions
disapointing->disappointing
disappearred->disappeared
disaproval->disapproval
disasterous->disastrous
disatisfaction->dissatisfaction
disatisfied->dissatisfied
disatrous->disastrous
discontentment->discontent
discribe->describe
discribed->described
discribes->describes
discribing->describing
disctinction->distinction
dispicable->despicable
dispite->despite
dispostion->disposition
disproportiate->disproportionate
disputandem->disputandum
disricts->districts
dissagreement->disagreement
dissapear->disappear
dissapearance->disappearance
dissapeared->disappeared
dissapearing->disappearing
dissapears->disappears
dissappear->disappear
dissappears->disappears
dissappointed->disappointed
dissarray->disarray
distruction->destruction
distructive->destructive
ditributed->distributed
diversed->diverse, diverged
divice->device
divinition->divination
divison->division
divisons->divisions
dum->dumb
doccument->document
doccumented->documented
doccuments->documents
docrines->doctrines
doctines->doctrines
documenatry->documentary
doens->does
doign->doing
effeciency->efficiency
effecient->efficient
effeciently->efficiently
efficency->efficiency
efficent->efficient
efficently->efficiently
efford->effort, afford
effords->efforts, affords
effulence->effluence
eigth->eighth, eight
eiter->either
elction->election
electic->eclectic, electric
electon->election, electron
electrial->electrical
electricly->electrically
electricty->electricity
elementay->elementary
eleminated->eliminated
eleminating->eliminating
eles->eels
eletricity->electricity
elicided->elicited
eligable->eligible
elimentary->elementary
ellected->elected
elphant->elephant
embarass->embarrass
embarassed->embarrassed
embarassing->embarrassing
embarassment->embarrassment
embargos->embargoes
embarras->embarrass
embarrased->embarrassed
embarrasing->embarrassing
embarrasment->embarrassment
embezelled->embezzled
emblamatic->emblematic
eminate->emanate
eminated->emanated
emision->emission
emited->emitted
emiting->emitting
emition->emission, emotion
emmediately->immediately
emmigrated->emigrated, immigrated
emminent->eminent, imminent
emminently->eminently
emmisaries->emissaries
emmisarries->emissaries
encryptiion->encryption
encylopedia->encyclopedia
endevors->endeavors
engieneer->engineer
engieneers->engineers
enlargment->enlargement
enlargments->enlargements
Enlish->English, enlist
enourmous->enormous
enourmously->enormously
ensconsed->ensconced
entaglements->entanglements
enteratinment->entertainment
enthusiatic->enthusiastic
entitity->entity
entitlied->entitled
entrepeneur->entrepreneur
enviornmentally->environmentally
enviornments->environments
enviroment->environment
enviromental->environmental
enviromentalist->environmentalist
enviromentally->environmentally
enviroments->environments
envolutionary->evolutionary
envrionments->environments
esential->essential
esitmated->estimated
esle->else
especialy->especially
essencial->essential
ethose->those, ethos
Europian->European
Europians->Europeans
Eurpean->European
Eurpoean->European
evenhtually->eventually
eventally->eventually
eventhough->even though
eventially->eventually
eventualy->eventually
everthing->everything
everytime->every time
everyting->everything
eveyr->every
evidentally->evidently
exagerate->exaggerate
exampt->exempt
exapansion->expansion
exerbated->exacerbated
exerciese->exercises
exerpt->excerpt
exerpts->excerpts
exersize->exercise
exerternal->external
exhalted->exalted
exhibtion->exhibition
exibition->exhibition
exibitions->exhibitions
exicting->exciting
exinct->extinct
existance->existence
existant->existent
existince->existence
exliled->exiled
exludes->excludes
exmaple->example
exonorate->exonerate
exoskelaton->exoskeleton
expalin->explain
expatriot->expatriate
expeced->expected
expecially->especially
expeditonary->expeditionary
expeiments->experiments
expell->expel
explotation->exploitation
facillitate->facilitate
facinated->fascinated
facist->fascist
familes->families
familliar->familiar
famoust->famous
fanatism->fanaticism
Farenheit->Fahrenheit
fatc->fact
faught->fought
fianite->finite
fianlly->finally
ficticious->fictitious
fictious->fictitious
fidn->find
fiel->feel, field, file, phial
fiels->feels, fields, files, phials
fiercly->fiercely
fightings->fighting
filiament->filament
fimilies->families
forhead->forehead
foriegn->foreign
Formalhaut->Fomalhaut
formallize->formalize
foudn->found
fougth->fought
foundaries->foundries
foundary->foundry
Foundland->Newfoundland
fourties->forties
fourty->forty
fouth->fourth
foward->forward
Fransiscan->Franciscan
Fransiscans->Franciscans
freind->friend
freindly->friendly
funguses->fungi
funtion->function
furuther->further
futher->further
genialia->genitalia
geographicial->geographical
geometrician->geometer
geometricians->geometers
gerat->great
Ghandi->Gandhi
glamourous->glamorous
glight->flight
gnawwed->gnawed
godess->goddess
godesses->goddesses
Godounov->Godunov
gogin->going, Gauguin
graet->great
grafitti->graffiti
gramatically->grammatically
grammaticaly->grammatically
grammer->grammar
grat->greatas
guidence->guidance
Guilia->Giulia
Guilio->Giulio
Guiness->Guinness
Guiseppe->Giuseppe
hapen->happen
hapened->happened
hapening->happening
happend->happened
happended->happened
happenned->happened
harased->harassed
harases->harasses
harasment->harassment
harasments->harassments
harassement->harassment
harras->harass
harrased->harassed
harrases->harasses
harrasing->harassing
harrasment->harassment
harrasments->harassments
harrassed->harassed
harrasses->harassed
harrassing->harassing
harrassment->harassment
harrassments->harassments
Hatian->Haitian
haviest->heaviest
headquarer->headquarter
headquater->headquarter
headquatered->headquartered
headquaters->headquarters
hertiage->heritage
hertzs->hertz
hesistant->hesitant
heterogenous->heterogeneous
hieght->height
hierachical->hierarchical
hierachies->hierarchies
hierachy->hierarchy
hierarcical->hierarchical
hten->then, hen, the
htere->there, here
htey->they
htikn->think
hting->thing
htink->think
htis->this
humer->humor, humour
humerous->humorous, humerus
huminoid->humanoid
humoural->humoral
humurous->humorous
husban->husband
hvae->have
hvaing->having
hvea->have, heave
hwihc->which
hwile->while
hwole->whole
hydogen->hydrogen
hydropile->hydrophile
hydropilic->hydrophilic
hydropobe->hydrophobe
imcomplete->incomplete
imediately->immediately
imense->immense
imigrant->emigrant, immigrant
imigrated->emigrated, immigrated
imigration->emigration, immigration
iminent->eminent, imminent, immanent
immediatley->immediately
immediatly->immediately
immidately->immediately
immidiately->immediately
immitate->imitate
immitated->imitated
immitating->imitating
immitator->imitator
immunosupressant->immunosuppressant
impecabbly->impeccably
impedence->impedance
implamenting->implementing
impliment->implement
implimented->implemented
inadvertantly->inadvertently
inagurated->inaugurated
inaguration->inauguration
inappropiate->inappropriate
inaugures->inaugurates
inbalance->imbalance
inbalanced->imbalanced
inbetween->between
incarcirated->incarcerated
incidentially->incidentally
incidently->incidentally
inclreased->increased
includ->include
includng->including
incompatabilities->incompatibilities
incompatability->incompatibility
incompatable->incompatible
incompatablities->incompatibilities
incompatablity->incompatibility
incuding->including
incunabla->incunabula
indefinately->indefinitely
indefineable->undefinable
indefinitly->indefinitely
indentical->identical
indepedantly->independently
indepedence->independence
independance->independence
independant->independent
independantly->independently
indpendently->independently
indulgue->indulge
indutrial->industrial
indviduals->individuals
inefficienty->inefficiently
inevatible->inevitable
inevitible->inevitable
inevititably->inevitably
infalability->infallibility
infallable->infallible
infectuous->infectious
infered->inferred
inpeach->impeach
inpending->impending
inpenetrable->impenetrable
inpolite->impolite
inprisonment->imprisonment
inproving->improving
insectiverous->insectivorous
insensative->insensitive
inseperable->inseparable
insistance->insistence
insitution->institution
insitutions->institutions
inspite->in spite, inspire
instade->instead
instatance->instance
institue->institute
instuction->instruction
instuments->instruments
instutionalized->institutionalized
instutions->institutions, intuitions
intevene->intervene
intial->initial
intially->initially
intrduced->introduced
intrest->interest
introdued->introduced
intruduced->introduced
intrument->instrument
intrumental->instrumental
intruments->instruments
intrusted->entrusted
intutive->intuitive
intutively->intuitively
inudstry->industry
inumerable->enumerable, innumerable
inventer->inventor
invertibrates->invertebrates
Japanes->Japanese
Juadaism->Judaism
Juadism->Judaism
judical->judicial
judisuary->judiciary
juducial->judicial
juristiction->jurisdiction
juristictions->jurisdictions
kindergarden->kindergarten
klenex->kleenex
labratory->laboratory
laguage->language
laguages->languages
larg->large
largst->largest
larrry->larry
lastr->last
lattitude->latitude
launchs->launch, launches
launhed->launched
lavae->larvae
layed->laid
leutenant->lieutenant
levetate->levitate
levetated->levitated
levetates->levitates
levetating->levitating
levle->level
liasion->liaison
liason->liaison
liftime->lifetime
lvoe->love
Lybia->Libya
maching->machine, marching, matching
mackeral->mackerel
magasine->magazine
magizine->magazine
magisine->magazine
magincian->magician
magnificient->magnificent
makse->makes
Malcom->Malcolm
maltesian->Maltese
mamal->mammal
mamalian->mammalian
managable->manageable, manageably
managment->management
maneouvre->manoeuvre
maneouvred->manoeuvred
maneouvres->manoeuvres
maneouvring->manoeuvring
manisfestations->manifestations
mathmaticians->mathematicians
mccarthyst->mccarthyist
mchanics->mechanics
meaninng->meaning
mear->wear, mere, mare
mechandise->merchandise
medacine->medicine
medeival->medieval
medevial->medieval
mediciney->mediciny
medievel->medieval
metalurgy->metallurgy
metamorphysis->metamorphosis
metaphoricial->metaphorical
meterologist->meteorologist
meterology->meteorology
methaphor->metaphor
methaphors->metaphors
Michagan->Michigan
millenialism->millennialism
millenium->millennium
millepede->millipede
millioniare->millionaire
millitant->militant
millitary->military
millon->million
miltary->military
minature->miniature
minerial->mineral
ministery->ministry
minsitry->ministry
misdameanors->misdemeanors
misdemenor->misdemeanor
misdemenors->misdemeanors
negociate->negotiate
negociation->negotiation
negociations->negotiations
negotation->negotiation
neice->niece, nice
neigborhood->neighborhood
neigbour->neighbour, neighbor
neigbourhood->neighbourhood
neigbouring->neighbouring, neighboring
neigbours->neighbours, neighbors
neolitic->neolithic
nessasarily->necessarily
nessecary->necessary
nestin->nesting
neverthless->nevertheless
newletters->newsletters
nickle->nickel
ocasion->occasion
ocasional->occasional
ocasionally->occasionally
ocasionaly->occasionally
ocasioned->occasioned
ocasions->occasions
ocassion->occasion
ocassional->occasional
ocassionally->occasionally
ocassionaly->occasionally
ocassioned->occasioned
ocassions->occasions
opponant->opponent
oppononent->opponent
oppositition->opposition
oppossed->opposed
oridinarily->ordinarily
origanaly->originally
originall->original, originally
originaly->originally
originially->originally
originnally->originally
oxigen->oxygen
oximoron->oxymoron
paide->paid
paitience->patience
palce->place, palace
paleolitic->paleolithic
paliamentarian->parliamentarian
Palistian->Palestinian
Palistinian->Palestinian
Palistinians->Palestinians
pallete->palette
pamflet->pamphlet
parrakeets->parakeets
parralel->parallel
parrallel->parallel
parrallell->parallel
parrallelly->parallelly
parrallely->parallelly
partialy->partially
particually->particularly
particualr->particular
peaples->peoples
peculure->peculiar
pedestrain->pedestrian
peformed->performed
peice->piece
Peloponnes->Peloponnesus
penatly->penalty
penerator->penetrator
penisula->peninsula
penisular->peninsular
penninsula->peninsula
penninsular->peninsular
pennisula->peninsula
Pennyslvania->Pennsylvania
pensle->pencil
pensinula->peninsula
peom->poem
peoms->poems
peopel->people
peopels->peoples
peotry->poetry
perade->parade
percepted->perceived
percieve->perceive
percieved->perceived
pertubation->perturbation
pertubations->perturbations
pessiary->pessary
petetion->petition
Pharoah->Pharaoh
phenomenom->phenomenon
phenomenonal->phenomenal
phenomenonly->phenomenally
phylosophical->philosophical
physicaly->physically
piblisher->publisher
pich->pitch
pilgrimmage->pilgrimage
pilgrimmages->pilgrimages
pinapple->pineapple
pinnaple->pineapple
pinoneered->pioneered
plagarism->plagiarism
planation->plantation
planed->planned
populer->popular
porshan->portion
porshon->portion
portait->portrait
portayed->portrayed
portraing->portraying
Portugese->Portuguese
portuguease->portuguese
portugues->Portuguese
posess->possess
posessed->possessed
posesses->possesses
posessing->possessing
posession->possession
possition->position
practicioners->practitioners
practicly->practically
practioner->practitioner
practioners->practitioners
prairy->prairie
prarie->prairie
praries->prairies
pratice->practice
preample->preamble
precedessor->predecessor
preceed->precede
preceeded->preceded
preceeding->preceding
preceeds->precedes
premeire->premiere
prespective->perspective
prestigeous->prestigious
prestigous->prestigious
presumabely->presumably
presumibly->presumably
pretection->protection
prevelant->prevalent
preverse->perverse
priveliged->privileged
priveliges->privileges
privelleges->privileges
privilage->privilege
priviledge->privilege
priviledges->privileges
privledge->privilege
proffesion->profession
proffesional->professional
proffesor->professor
proffession->profession
proffessional->professional
proffessor->professor
profilic->prolific
progessed->progressed
progidy->prodigy
programable->programmable
progrom->pogrom, program
progroms->pogroms, programs
prohabition->prohibition
prologomena->prolegomena
prominance->prominence
proove->prove
prooved->proved
prophacy->prophecy
propietary->proprietary
propmted->prompted
propoganda->propaganda
propogate->propagate
propogates->propagates
propogation->propagation
protruberances->protuberances
prouncements->pronouncements
provacative->provocative
provded->provided
provicial->provincial
provinicial->provincial
provisiosn->provision
provisonal->provisional
proximty->proximity
pseudononymous->pseudonymous
pseudonyn->pseudonym
psuedo->pseudo
qtuie->quite, quiet
quantaty->quantity
quantitiy->quantity
quarantaine->quarantine
Queenland->Queensland
questonable->questionable
quicklyu->quickly
quinessential->quintessential
quitted->quit
quizes->quizzes
realitvely->relatively
realsitic->realistic
realtions->relations
realy->really
realyl->really
reasearch->research
rebiulding->rebuilding
rebllions->rebellions
rebounce->rebound
reccomend->recommend
reccomendations->recommendations
reccomended->recommended
recide->reside
recided->resided
recident->resident
recivership->receivership
recogise->recognise
recogize->recognize
recomend->recommend
recomended->recommended
recomending->recommending
recomends->recommends
recommedations->recommendations
recompence->recompense
reconaissance->reconnaissance
recurrance->recurrence
rediculous->ridiculous
reedeming->redeeming
releive->relieve
releived->relieved
releiver->reliever
releses->releases
rememberance->remembrance
remembrence->remembrance
remenant->remnant
remenicent->reminiscent
reminent->remnant
reminescent->reminiscent
reminscent->reminiscent
reminsicent->reminiscent
rendevous->rendezvous
rendezous->rendezvous
renedered->rende
repblic->republic
repblican->republican
repblicans->republicans
repblics->republics
repectively->respectively
repeition->repetition
reprtoire->repertoire
repsectively->respectively
reptition->repetition
repubic->republic
repubican->republican
repubicans->republicans
repubics->republics
resembes->resembles
resemblence->resemblance
resevoir->reservoir
residental->residential
resignement->resignment
resistable->resistible
resistence->resistance
resistent->resistant
respectivly->respectively
responce->response
responibilities->responsibilities
responisble->responsible
resssurecting->resurrecting
restauranteurs->restaurateurs
restauration->restoration
restauraunt->restaurant
resteraunt->restaurant
resteraunts->restaurants
resticted->restricted
restraunt->restraint, restaurant
resturant->restaurant
resturants->restaurants
resturaunt->restaurant
resturaunts->restaurants
resurecting->resurrecting
retalitated->retaliated
retalitation->retaliation
retreive->retrieve
returnd->returned
revaluated->reevaluated
reveiw->review
reveral->reversal
reversable->reversible
revolutionar->revolutionary
rewitten->rewritten
rewriet->rewrite
rference->reference
rocord->record
roomate->roommate
rougly->roughly
rucuperate->recuperate
rudimentatry->rudimentary
rulle->rule
runing->running
runnung->running
russina->Russian
Russion->Russian
rwite->write
rythem->rhythm
rythim->rhythm
rythm->rhythm
rythmic->rhythmic
rythyms->rhythms
sacrafice->sacrifice
sacreligious->sacrilegious
Sacremento->Sacramento
sacrifical->sacrificial
saftey->safety
safty->safety
salery->salary
sanctionning->sanctioning
satrically->satirically
sattelite->satellite
sattelites->satellites
saught->sought
saveing->saving
saxaphone->saxophone
scaleable->scalable
scandanavia->Scandinavia
scaricity->scarcity
scavanged->scavenged
scrutinity->scrutiny
scuptures->sculptures
seach->search
seached->searched
seaches->searches
secceeded->seceded, succeeded
seceed->succeed, secede
seceeded->succeeded, seceded
secratary->secretary
secretery->secretary
sedereal->sidereal
seeked->sought
segementation->segmentation
seguoys->segues
seige->siege
seing->seeing
seinor->senior
seldomly->seldom
senarios->scenarios
sence->sense, since
senstive->sensitive
shamen->shaman, shamans
sheat->sheath, sheet, cheat
sheild->shield
sherif->sheriff
shineing->shining
shiped->shipped
shiping->shipping
shopkeeepers->shopkeepers
shorly->shortly
shortwhile->short while
shoudl->should
shouldnt->should not
shreak->shriek
shrinked->shrunk
sicne->since
sideral->sidereal
sieze->seize, size
siezed->seized, sized
siezing->seizing, sizing
siezure->seizure
siezures->seizures
siginificant->significant
signficant->significant
signficiant->significant
signfies->signifies
signifantly->significantly
significently->significantly
signifigant->significant
signifigantly->significantly
signitories->signatories
simultanously->simultaneously
sincerley->sincerely
singsog->singsong
sinse->sines, since
Sionist->Zionist
sofware->software
sohw->show
soilders->soldiers
solatary->solitary
soley->solely
soliders->soldiers
soliliquy->soliloquy
soluable->soluble
somene->someone
somtimes->sometimes
somwhere->somewhere
sophicated->sophisticated
sophmore->sophomore
sorceror->sorcerer
sorrounding->surrounding
sotry->story
sotyr->satyr, story
soudn->sound
soudns->sounds
sould->could, should, sold, soul
sountrack->soundtrack
sourth->south
sourthern->southern
souvenier->souvenir
souveniers->souvenirs
soveits->soviets
sovereignity->sovereignty
soverign->sovereign
soverignity->sovereignty
soverignty->sovereignty
spectum->spectrum
speices->species
spendour->splendour
spermatozoan->spermatozoon
spoace->space
sponser->sponsor
sponsered->sponsored
spontanous->spontaneous
sponzored->sponsored
spoonfulls->spoonfuls
sppeches->speeches
spreaded->spread
sprech->speech
spred->spread
spriritual->spiritual
spritual->spiritual
sqaure->square
stablility->stability
stainlees->stainless
staion->station
standars->standards
stange->strange
startegic->strategic
startegies->strategies
startegy->strategy
stateman->statesman
statememts->statements
statment->statement
steriods->steroids
sterotypes->stereotypes
stilus->stylus
stingent->stringent
stiring->stirring
stirrs->stirs
stlye->style
streemlining->streamlining
stregth->strength
strenghen->strengthen
strenghened->strengthened
strenghening->strengthening
strenght->strength
strenghten->strengthen
strenghtened->strengthened
strenghtening->strengthening
strengtened->strengthened
strenous->strenuous
strictist->strictest
strikely->strikingly
strnad->strand
stroy->story, destroy
structual->structural
stubborness->stubbornness
stucture->structure
stuctured->structured
studdy->study
studing->studying
stuggling->struggling
sturcture->structure
subcatagories->subcategories
subcatagory->subcategory
subconsiously->subconsciously
subdivisio->subdivision
subjudgation->subjugation
submachne->submachine
subtances->substances
subterranian->subterranean
suburburban->suburban
succceeded->succeeded
succcesses->successes
succedded->succeeded
succeded->succeeded
succeds->succeeds
succesful->successful
succesfully->successfully
succesfuly->successfully
succesion->succession
succesive->successive
successfull->successful
successully->successfully
succsess->success
succsessfull->successful
suceed->succeed
suceeded->succeeded
suceeding->succeeding
sucession->succession
sucessive->successive
sucessor->successor
sucessot->successor
suphisticated->sophisticated
suplimented->supplemented
supose->suppose
suposed->supposed
suposedly->supposedly
suposes->supposes
suposing->supposing
supplamented->supplemented
suppliementing->supplementing
surfce->surface
surley->surly, surely
suround->surround
surounded->surrounded
surounding->surrounding
suroundings->surroundings
surounds->surrounds
surplanted->supplanted
surpress->suppress
surpressed->suppressed
surprize->surprise
surprized->surprised
survivied->survived
suseptable->susceptible
suseptible->susceptible
symmetricaly->symmetrically
synagouge->synagogue>taxonomic
taxanomy->taxonomy
teached->taught
techician->technician
techicians->technicians
techiniques->techniques
technitian->technician
technnology->technology
technolgy->technology
teh->the
tehy->they
temprary->temporary
tenacle->tentacle
tenacles->tentacles
tendacy->tendency
tendancies->tendencies
tendancy->tendency
tennisplayer->tennis player
tepmorarily->temporarily
themslves->themselves
ther->there, their, the
therafter->thereafter
therby->thereby
theri->their
thgat->that
threshhold->threshold
thrid->third
throrough->thorough
throughly->thoroughly
throught->thought, through, throughout
througout->throughout
thru->through
thsi->this
thsoe->those
thta->that
thyat->that
tiem->time, Tim
tommorow->tomorrow
tommorrow->tomorrow
tongiht->tonight
toriodal->toroidal
tormenters->tormentors
tornadoe->tornado
torpeados->torpedoes
torpedos->torpedoes
tortise->tortoise
tothe->to the
toubles->troubles
tounge->tonguesher
uise->use
Ukranian->Ukrainian
ultimely->ultimately
unacompanied->unaccompanied
unahppy->unhappy
unanymous->unanimous
unathorised->unauthorised
unavailible->unavailable
unballance->unbalance
undetecable->undetectable
undoubtely->undoubtedly
undreground->underground
uneccesary->unnecessary
UnitesStates->UnitedStates
univeral->universal
univeristies->universities
univeristy->university
unsucessfully->unsuccessfully
unsuprised->unsurprised
unsuprising->unsurprising
unsuprisingly->unsurprisingly
unsuprized->unsurprised
unsuprizing->unsurprising
unsuprizingly->unsurprisingly
unsurprized->unsurprised
unsurprizing->unsurprising
unsurprizingly->unsurprisingly
vaccum->vacuum
vaccume->vacuum
vacinity->vicinity
vaguaries->vagaries
vaieties->varieties
vailidty->validity
valetta->valletta
valuble->valuable
valueable->valuable
varations->variations
vrey->very
weilded->wielded
wendsay->Wednesday
wensday->Wednesday
wereabouts->whereabouts
whant->want
whants->wants
whcih->which
wheras->whereas
wherease->whereas
whereever->wherever
whic->which
whihc->which
whith->with
whlch->which
whn->when
wholey->wholly
wholy->wholly, holy
whta->what
whther->whether
xenophoby->xenophobia
yaching->yachting
yaer->year
yaerly->yearly
yaers->years
yatch->yacht
yearm->year
yeasr->years
yeild->yield
yeilding->yielding
Yementite->Yemenite, Yemeni
yera->year
yrea->year
yeras->years
yersa->years
yotube->youtube
youseff->yousef
youself->yourself
ytou->you
yuo->you
zeebra->zebra
adn->and
